13 × 15の大きさの迷路

■■■■■■■■■■■■■
■　　　　　　　　　　　■
■　■■■　■　■　■■■
■　　　■　■　■　　　■
■　■　■■■■■■■■■
■　■　　　　　　　　　■
■　■■■　■　■　■　■
■　　　■　■　■　■　■
■　■■■■■■■■■■■
■　　　　　　　■　　　■
■　■■■■■■■　■■■
■　　　　　　　　　■　■
■　■■■■■　■　■　■
■　　　　　■　■　　　■
■■■■■■■■■■■■■
